1111111111111
1C011C10000C1
1000001C00001
1010101111011
1010100010001
1010101010101
1010101010101
1P1C0010001E1
1111111111111