111111111
1P0C001E1
100000001
111111111